_____*__**___*****___________
_____****************________
____**********************___
____************************_
__***************************
___************************__
_____*********************___
________******************___
__________***************____
_____________***********_____
______________*********______
_______________******________
______________******_________
_____________******__________
_____________*****___________